["1111111111111111",
 "1..............1",
 "1..............1",
 "1..1........11.1",
 "1..............1",
 "1..............1",
 "1.P11.....111..1",
 "1..1.....1...1.1",
 ".........11111.1",
 "1..............1",
 "1...1.....1....1",
 "1111111111111111"]
