["1111111111111111",
 "1..............1",
 "1..............1",
 "1.....1....1...1",
 "1...............",
 "1..............1",
 "1.1111P.....1..1",
 "1..1.....1...1.1",
 ".........11111.1",
 "1..............1",
 "1...1......1...1",
 "1111111111111111"]
