["1111111111111111",
"1..............1",
"1..............1",
"1..1........11.1",
"1..............1",
"1..............1",
"1.111.....P....1",
"1..1.....1...1.1",
".........11111.1",
"1..............1",
"1...1.....1....1",
"111111111.111111"]
