["1111111111111111",
"1..............1",
"1..............1",
"1...1.....1.....",
"1..............1",
"1..............1",
"1..1.....P....11",
"1..1.....1...1.1",
".........11111.1",
"1..............1",
"1.11111.....1..1",
"11111111.1111111"]
